........w................w................w................w................w................w......
.w.www.www.www.w..w.www.www.www.w..w.www.www.www.w..w.www.www.www.w..w.www.www.www.w..w.www.www.www.
.w...w.....w...w..w...w.....w...w..w...w.....w...w..w...w.....w...w..w...w.....w...w..w...w.....w...
ww.w.www.www.w.wwww.w.www.www.w.wwww.w.www.www.w.wwww.w.www.www.w.wwww.w.www.www.w.wwww.w.www.www.w.
.w.w.w.....w.w.w..w.w.w.....w.w.w..w.w.w.....w.w.w..w.w.w.....w.w.w..w.w.w.....w.w.w..w.w.w.....w.w.
...w.w.www.w.w......w.w.www.w.w......w.w.www.w.w......w.w.www.w.w......w.w.www.w.w......w.w.www.w.w.
.w.w.w..w..w.w.w..w.w.w..w..w.w.w..w.w.w..w..w.w.w..w.w.w..w..w.w.w..w.w.w..w..w.w.w..w.w.w..w..w.w.
.w.w....w....w.w..w.w....w....w.w..w.w....w....w.w..w.w....w....w.w..w.w....w....w.w..w.w....w....w.
.www.wwwwwww.www..www.wwwwwww.www..www.wwwwwww.www..www.wwwwwww.www..www.wwwwwww.www..www.wwwwwww.ww
.w.w....w....w.w..w.w....w....w.w..w.w....w....w.w..w.w....w....w.w..w.w....w....w.w..w.w....w....w.
.w.w.w..w..w.w.w..w.w.w..w..w.w.w..w.w.w..w..w.w.w..w.w.w..w..w.w.w..w.w.w..w..w.w.w..w.w.w..w..w.w.
...w.w.www.w.w......w.w.www.w.w......w.w.www.w.w......w.w.www.w.w......w.w.www.w.w......w.w.www.w.w.
.w.w.w.....w.w.w..w.w.w.....w.w.w..w.w.w.....w.w.w..w.w.w.....w.w.w..w.w.w.....w.w.w..w.w.w.....w.w.
ww.w.www.www.w.wwww.w.www.www.w.wwww.w.www.www.w.wwww.w.www.www.w.wwww.w.www.www.w.wwww.w.www.www.w.
.w...w.....w...w..w...w.....w...w..w...w.....w...w..w...w.....w...w..w...w.....w...w..w...w.....w...
.w.www.www.www.w..w.www.www.www.w..w.www.www.www.w..w.www.www.www.w..w.www.www.www.w..w.www.www.www.
........w................w................w................w................w................w......
........w................w................w................w................w................w......
.w.www.www.www.w..w.www.www.www.w..w.www.www.www.w..w.www.www.www.w..w.www.www.www.w..w.www.www.www.
.w...w.....w...w..w...w.....w...w..w...w.....w...w..w...w.....w...w..w...w.....w...w..w...w.....w...
ww.w.www.www.w.wwww.w.www.www.w.wwww.w.www.www.w.wwww.w.www.www.w.wwww.w.www.www.w.wwww.w.www.www.w.
.w.w.w.....w.w.w..w.w.w.....w.w.w..w.w.w.....w.w.w..w.w.w.....w.w.w..w.w.w.....w.w.w..w.w.w.....w.w.
...w.w.www.w.w......w.w.www.w.w......w.w.www.w.w......w.w.www.w.w......w.w.www.w.w......w.w.www.w.w.
.w.w.w..w..w.w.w..w.w.w..w..w.w.w..w.w.w..w..w.w.w..w.w.w..w..w.w.w..w.w.w..w..w.w.w..w.w.w..w..w.w.
.w.w....w....w.w..w.w....w....w.w..w.w....w....w.w..w.w....w....w.w..w.w....w....w.w..w.w....w....w.
.www.wwwwwww.www..www.wwwwwww.www..www.wwwwwww.www..www.wwwwwww.www..www.wwwwwww.www..www.wwwwwww.ww
.w.w....w....w.w..w.w....w....w.w..w.w....w....w.w..w.w....w....w.w..w.w....w....w.w..w.w....w....w.
.w.w.w..w..w.w.w..w.w.w..w..w.w.w..w.w.w..w..w.w.w..w.w.w..w..w.w.w..w.w.w..w..w.w.w..w.w.w..w..w.w.
...w.w.www.w.w......w.w.www.w.w......w.w.www.w.w......w.w.www.w.w......w.w.www.w.w......w.w.www.w.w.
.w.w.w.....w.w.w..w.w.w.....w.w.w..w.w.w.....w.w.w..w.w.w.....w.w.w..w.w.w.....w.w.w..w.w.w.....w.w.
ww.w.www.www.w.wwww.w.www.www.w.wwww.w.www.www.w.wwww.w.www.www.w.wwww.w.www.www.w.wwww.w.www.www.w.
.w...w.....w...w..w...w.....w...w..w...w.....w...w..w...w.....w...w..w...w.....w...w..w...w.....w...
.w.www.www.www.w..w.www.www.www.w..w.www.www.www.w..w.www.www.www.w..w.www.www.www.w..w.www.www.www.
........w................w................w................w................w................w......
........w................w................w................w................w................w......
.w.www.www.www.w..w.www.www.www.w..w.www.www.www.w..w.www.www.www.w..w.www.www.www.w..w.www.www.www.
.w...w.....w...w..w...w.....w...w..w...w.....w...w..w...w.....w...w..w...w.....w...w..w...w.....w...
ww.w.www.www.w.wwww.w.www.www.w.wwww.w.www.www.w.wwww.w.www.www.w.wwww.w.www.www.w.wwww.w.www.www.w.
.w.w.w.....w.w.w..w.w.w.....w.w.w..w.w.w.....w.w.w..w.w.w.....w.w.w..w.w.w.....w.w.w..w.w.w.....w.w.
...w.w.www.w.w......w.w.www.w.w......w.w.www.w.w......w.w.www.w.w......w.w.www.w.w......w.w.www.w.w.
.w.w.w..w..w.w.w..w.w.w..w..w.w.w..w.w.w..w..w.w.w..w.w.w..w..w.w.w..w.w.w..w..w.w.w..w.w.w..w..w.w.
.w.w....w....w.w..w.w....w....w.w..w.w....w....w.w..w.w....w....w.w..w.w....w....w.w..w.w....w....w.
.www.wwwwwww.www..www.wwwwwww.www..www.wwwwwww.www..www.wwwwwww.www..www.wwwwwww.www..www.wwwwwww.ww
.w.w....w....w.w..w.w....w....w.w..w.w....w....w.w..w.w....w....w.w..w.w....w....w.w..w.w....w....w.
.w.w.w..w..w.w.w..w.w.w..w..w.w.w..w.w.w..w..w.w.w..w.w.w..w..w.w.w..w.w.w..w..w.w.w..w.w.w..w..w.w.
...w.w.www.w.w......w.w.www.w.w......w.w.www.w.w......w.w.www.w.w......w.w.www.w.w......w.w.www.w.w.
.w.w.w.....w.w.w..w.w.w.....w.w.w..w.w.w.....w.w.w..w.w.w.....w.w.w..w.w.w.....w.w.w..w.w.w.....w.w.
ww.w.www.www.w.wwww.w.www.www.w.wwww.w.www.www.w.wwww.w.www.www.w.wwww.w.www.www.w.wwww.w.www.www.w.
.w...w.....w...w..w...w.....w...w..w...w.....w...w..w...w.....w...w..w...w.....w...w..w...w.....w...
.w.www.www.www.w..w.www.www.www.w..w.www.www.www.w..w.www.www.www.w..w.www.www.www.w..w.www.www.www.
........w................w................w................w................w................w......
........w................w................w................w................w................w......
.w.www.www.www.w..w.www.www.www.w..w.www.www.www.w..w.www.www.www.w..w.www.www.www.w..w.www.www.www.
.w...w.....w...w..w...w.....w...w..w...w.....w...w..w...w.....w...w..w...w.....w...w..w...w.....w...
ww.w.www.www.w.wwww.w.www.www.w.wwww.w.www.www.w.wwww.w.www.www.w.wwww.w.www.www.w.wwww.w.www.www.w.
.w.w.w.....w.w.w..w.w.w.....w.w.w..w.w.w.....w.w.w..w.w.w.....w.w.w..w.w.w.....w.w.w..w.w.w.....w.w.
...w.w.www.w.w......w.w.www.w.w......w.w.www.w.w......w.w.www.w.w......w.w.www.w.w......w.w.www.w.w.
.w.w.w..w..w.w.w..w.w.w..w..w.w.w..w.w.w..w..w.w.w..w.w.w..w..w.w.w..w.w.w..w..w.w.w..w.w.w..w..w.w.
.w.w....w....w.w..w.w....w....w.w..w.w....w....w.w..w.w....w....w.w..w.w....w....w.w..w.w....w....w.
.www.wwwwwww.www..www.wwwwwww.www..www.wwwwwww.www..www.wwwwwww.www..www.wwwwwww.www..www.wwwwwww.ww
.w.w....w....w.w..w.w....w....w.w..w.w....w....w.w..w.w....w....w.w..w.w....w....w.w..w.w....w....w.
.w.w.w..w..w.w.w..w.w.w..w..w.w.w..w.w.w..w..w.w.w..w.w.w..w..w.w.w..w.w.w..w..w.w.w..w.w.w..w..w.w.
...w.w.www.w.w......w.w.www.w.w......w.w.www.w.w......w.w.www.w.w......w.w.www.w.w......w.w.www.w.w.
.w.w.w.....w.w.w..w.w.w.....w.w.w..w.w.w.....w.w.w..w.w.w.....w.w.w..w.w.w.....w.w.w..w.w.w.....w.w.
ww.w.www.www.w.wwww.w.www.www.w.wwww.w.www.www.w.wwww.w.www.www.w.wwww.w.www.www.w.wwww.w.www.www.w.
.w...w.....w...w..w...w.....w...w..w...w.....w...w..w...w.....w...w..w...w.....w...w..w...w.....w...
.w.www.www.www.w..w.www.www.www.w..w.www.www.www.w..w.www.www.www.w..w.www.www.www.w..w.www.www.www.
........w................w................w................w................w................w......
........w................w................w................w................w................w......
.w.www.www.www.w..w.www.www.www.w..w.www.www.www.w..w.www.www.www.w..w.www.www.www.w..w.www.www.www.
.w...w.....w...w..w...w.....w...w..w...w.....w...w..w...w.....w...w..w...w.....w...w..w...w.....w...
ww.w.www.www.w.wwww.w.www.www.w.wwww.w.www.www.w.wwww.w.www.www.w.wwww.w.www.www.w.wwww.w.www.www.w.
.w.w.w.....w.w.w..w.w.w.....w.w.w..w.w.w.....w.w.w..w.w.w.....w.w.w..w.w.w.....w.w.w..w.w.w.....w.w.
...w.w.www.w.w......w.w.www.w.w......w.w.www.w.w......w.w.www.w.w......w.w.www.w.w......w.w.www.w.w.
.w.w.w..w..w.w.w..w.w.w..w..w.w.w..w.w.w..w..w.w.w..w.w.w..w..w.w.w..w.w.w..w..w.w.w..w.w.w..w..w.w.
.w.w....w....w.w..w.w....w....w.w..w.w....w....w.w..w.w....w....w.w..w.w....w....w.w..w.w....w....w.
.www.wwwwwww.www..www.wwwwwww.www..www.wwwwwww.www..www.wwwwwww.www..www.wwwwwww.www..www.wwwwwww.ww
.w.w....w....w.w..w.w....w....w.w..w.w....w....w.w..w.w....w....w.w..w.w....w....w.w..w.w....w....w.
.w.w.w..w..w.w.w..w.w.w..w..w.w.w..w.w.w..w..w.w.w..w.w.w..w..w.w.w..w.w.w..w..w.w.w..w.w.w..w..w.w.
...w.w.www.w.w......w.w.www.w.w......w.w.www.w.w......w.w.www.w.w......w.w.www.w.w......w.w.www.w.w.
.w.w.w.....w.w.w..w.w.w.....w.w.w..w.w.w.....w.w.w..w.w.w.....w.w.w..w.w.w.....w.w.w..w.w.w.....w.w.
ww.w.www.www.w.wwww.w.www.www.w.wwww.w.www.www.w.wwww.w.www.www.w.wwww.w.www.www.w.wwww.w.www.www.w.
.w...w.....w...w..w...w.....w...w..w...w.....w...w..w...w.....w...w..w...w.....w...w..w...w.....w...
.w.www.www.www.w..w.www.www.www.w..w.www.www.www.w..w.www.www.www.w..w.www.www.www.w..w.www.www.www.
........w................w................w................w................w................w......
........w................w................w................w................w................w......
.w.www.www.www.w..w.www.www.www.w..w.www.www.www.w..w.www.www.www.w..w.www.www.www.w..w.www.www.www.
.w...w.....w...w..w...w.....w...w..w...w.....w...w..w...w.....w...w..w...w.....w...w..w...w.....w...
ww.w.www.www.w.wwww.w.www.www.w.wwww.w.www.www.w.wwww.w.www.www.w.wwww.w.www.www.w.wwww.w.www.www.w.
.w.w.w.....w.w.w..w.w.w.....w.w.w..w.w.w.....w.w.w..w.w.w.....w.w.w..w.w.w.....w.w.w..w.w.w.....w.w.
...w.w.www.w.w......w.w.www.w.w......w.w.www.w.w......w.w.www.w.w......w.w.www.w.w......w.w.www.w.w.
.w.w.w..w..w.w.w..w.w.w..w..w.w.w..w.w.w..w..w.w.w..w.w.w..w..w.w.w..w.w.w..w..w.w.w..w.w.w..w..w.w.
.w.w....w....w.w..w.w....w....w.w..w.w....w....w.w..w.w....w....w.w..w.w....w....w.w..w.w....w....w.
.www.wwwwwww.www..www.wwwwwww.www..www.wwwwwww.www..www.wwwwwww.www..www.wwwwwww.www..www.wwwwwww.ww
.w.w....w....w.w..w.w....w....w.w..w.w....w....w.w..w.w....w....w.w..w.w....w....w.w..w.w....w....w.
.w.w.w..w..w.w.w..w.w.w..w..w.w.w..w.w.w..w..w.w.w..w.w.w..w..w.w.w..w.w.w..w..w.w.w..w.w.w..w..w.w.
...w.w.www.w.w......w.w.www.w.w......w.w.www.w.w......w.w.www.w.w......w.w.www.w.w......w.w.www.w.w.
.w.w.w.....w.w.w..w.w.w.....w.w.w..w.w.w.....w.w.w..w.w.w.....w.w.w..w.w.w.....w.w.w..w.w.w.....w.w.
ww.w.www.www.w.wwww.w.www.www.w.wwww.w.www.www.w.wwww.w.www.www.w.wwww.w.www.www.w.wwww.w.www.www.w.
.w...w.....w...w..w...w.....w...w..w...w.....w...w..w...w.....w...w..w...w.....w...w..w...w.....w...